NO res/north_texture.png
SO res/south_texture.png
WE res/west_texture.png
EA res/east_texture.png

F 139,69,19
C 194,255,255

                            111111111
                            11000000111
                            1000000001
1111111111111111111111      1000000001
1100000000000000000011      110111111
10000000011110000000001      1001
1000000001111000000001      1001
1000000000000000000001      101
1100000001111000000011      101
1100000001111000000011      101
1000000000000000000001      101
1100000001111000000011      101
1100000001111000000011      101
1000000000000000000001      1011
1100000001111000000011      101
1100000001111000000011      101
1000000000000000000001     1001
1100000001111000000011     101
1100000001  1000000011    1001
1100000001111000000011    1001
1000000000000000000001    1001
110000000111100000001111111001
1100000001111100111111000000011
10000000000010000000E0001111111
100000000011000000001111
1100000001111000000011
1111111111111111111111