NO res/north_texture.png
SO res/south_texture.png
WE res/west_texture.png
EA res/east_texture.png

F 150,90,90
C 194,255,255

1111111111111111111111
1100000000000000000011
1000000001111000000001
1000000001111000000001
1000000000000000000001
1100000E01111000000011
1100000001111000000011
1000000000000000000001
1100000001111000000011
1100000001111000000011
1000000000000000000001
1100000001111000000011
1100000001111000000011
1000000000000000000001
1100000001111000000011
1100000001  1000000011
1100000001  1000000011
1100000001111000000011
1000000000000000000001
1000000000110000000001
1100000001111000000011
1111111111111111111111
