NO ../res/north_texture.png
SO ../res/south_texture.png
WE ../res/west_texture.png
EA ../res/east_texture.png

F 0,100,200
C 100,100,100

 11111
 10N01
 11111
 