NO res/north_texture.png
SO res/south_texture.png
WE res/west_texture.png
EA res/east_texture.png

F 150,90,90
C 194,255,255

111111111111111111111
110000000000000000011
1W0000000111000000001
100000000111000000001
110000000000000000011
110000000000000000011
100000000111000000001
100000000111000000001
110000000000000000011
111111111111111111111